__label__aar	Afar
__label__abk	Abkhazian
__label__acw	Hijazi-Arabic
__label__afb	Gulf-Arabic
__label__afr	Afrikaans
__label__ajp	South-Levantine-Arabic
__label__akk	Akkadian
__label__ale	Aleut
__label__amh	Amharic
__label__ang	Old-English-(ca.-450-1100)
__label__aot	Atong-(India)
__label__ara	Arabic
__label__arc	Official-Aramaic-(700-300-BCE)
__label__arg	Aragonese
__label__ary	Moroccan-Arabic
__label__arz	Egyptian-Arabic
__label__asm	Assamese
__label__ast	Asturian
__label__ayl	Libyan-Arabic
__label__aze	Azerbaijani
__label__bak	Bashkir
__label__ban	Balinese
__label__bar	Bavarian
__label__bbl	Bats
__label__bbn	Uneapa
__label__bcl	Central-Bikol
__label__bdq	Bahnar
__label__ben	Bengali
__label__bjb	Banggarla
__label__bod	Tibetan
__label__bre	Breton
__label__bua	Buriat
__label__cat	Catalan
__label__cbn	Nyahkur
__label__ceb	Cebuano
__label__chb	Chibcha
__label__che	Chechen
__label__cho	Choctaw
__label__chr	Cherokee
__label__cic	Chickasaw
__label__ckb	Central-Kurdish
__label__cnk	Khumi-Chin
__label__cop	Coptic
__label__cor	Cornish
__label__cos	Corsican
__label__crk	Plains-Cree
__label__crx	Carrier
__label__csb	Kashubian
__label__dan	Danish
__label__deu	German
__label__div	Dhivehi
__label__dlm	Dalmatian
__label__dng	Dungan
__label__dsb	Lower-Sorbian
__label__dum	Middle-Dutch-(ca.-1050-1350)
__label__dzo	Dzongkha
__label__egy	Egyptian-(Ancient)
__label__ell	Modern-Greek-(1453-)
__label__enm	Middle-English-(1100-1500)
__label__epo	Esperanto
__label__est	Estonian
__label__ett	Etruscan
__label__eus	Basque
__label__evn	Evenki
__label__ewe	Ewe
__label__fao	Faroese
__label__fas	Persian
__label__fax	Fala
__label__fin	Finnish
__label__fra	French
__label__fro	Old-French-(842-ca.-1400)
__label__frr	Northern-Frisian
__label__fry	Western-Frisian
__label__gla	Scottish-Gaelic
__label__gle	Irish
__label__glg	Galician
__label__glv	Manx
__label__gml	Middle-Low-German
__label__goh	Old-High-German-(ca.-750-1050)
__label__got	Gothic
__label__grc	Ancient-Greek-(to-1453)
__label__grn	Guarani
__label__gsw	Swiss-German
__label__guj	Gujarati
__label__gur	Farefare
__label__guw	Gun
__label__hat	Haitian
__label__hau	Hausa
__label__haw	Hawaiian
__label__hbs	Serbo-Croatian
__label__hbs	Serbo-Croatian
__label__heb	Hebrew
__label__hil	Hiligaynon
__label__hin	Hindi
__label__hrx	Hunsrik
__label__hsb	Upper-Sorbian
__label__hts	Hadza
__label__iba	Iban
__label__ido	Ido
__label__ilo	Iloko
__label__ina	Interlingua-(International-Auxiliary-Language-Association)
__label__ind	Indonesian
__label__inh	Ingush
__label__isl	Icelandic
__label__ita	Italian
__label__izh	Ingrian
__label__jam	Jamaican-Creole-English
__label__jav	Javanese
__label__jje	Jejueo
__label__kal	Kalaallisut
__label__kan	Kannada
__label__kas	Kashmiri
__label__kas	Kashmiri
__label__kat	Georgian
__label__kaw	Kawi
__label__kaz	Kazakh
__label__kgp	Kaingang
__label__khb	Lü
__label__khm	Khmer
__label__kik	Kikuyu
__label__kir	Kirghiz
__label__kix	Khiamniungan-Naga
__label__kld	Gamilaraay
__label__kmr	Northern-Kurdish
__label__koi	Komi-Permyak
__label__kok	Konkani-(macrolanguage)
__label__kpv	Komi-Zyrian
__label__krl	Karelian
__label__ksw	S'gaw-Karen
__label__ktz	Juǀʼhoan
__label__kwk	Kwakiutl
__label__kxd	Brunei
__label__kyu	Western-Kayah
__label__lad	Ladino
__label__lif	Limbu
__label__lij	Ligurian
__label__lim	Limburgan
__label__lit	Lithuanian
__label__liv	Liv
__label__lmo	Lombard
__label__lou	Louisiana-Creole
__label__lsi	Lashi
__label__ltz	Luxembourgish
__label__lut	Lushootseed
__label__lwl	Eastern-Lawa
__label__lzz	Laz
__label__mah	Marshallese
__label__mal	Malayalam
__label__mar	Marathi
__label__mdf	Moksha
__label__mfe	Morisyen
__label__mga	Middle-Irish-(900-1200)
__label__mic	Mi'kmaq
__label__mlg	Malagasy
__label__mlt	Maltese
__label__mnw	Mon
__label__mon	Mongolian
__label__mqs	West-Makian
__label__msa	Malay-(macrolanguage)
__label__msa	Malay-(macrolanguage)
__label__mtq	Muong
__label__mww	Hmong-Daw
__label__mya	Burmese
__label__nap	Neapolitan
__label__nav	Navajo
__label__nci	Classical-Nahuatl
__label__nds	Low-German
__label__nhn	Central-Nahuatl
__label__nhx	Isthmus-Mecayapan-Nahuatl
__label__niv	Gilyak
__label__nld	Dutch
__label__nno	Norwegian-Nynorsk
__label__nob	Norwegian-Bokmål
__label__non	Old-Norse
__label__nor	Norwegian
__label__nrf	Jèrriais
__label__nup	Nupe-Nupe-Tako
__label__nya	Nyanja
__label__oci	Occitan-(post-1500)
__label__ofs	Old-Frisian
__label__okm	Middle-Korean-(10th-16th-cent.)
__label__olo	Livvi
__label__orv	Old-Russian
__label__osp	Old-Spanish
__label__osx	Old-Saxon
__label__ota	Ottoman-Turkish-(1500-1928)
__label__pag	Pangasinan
__label__pam	Pampanga
__label__pan	Panjabi
__label__pan	Panjabi
__label__pbv	Pnar
__label__pcc	Bouyei
__label__pdc	Pennsylvania-German
__label__phl	Phalura
__label__pms	Piemontese
__label__pol	Polish
__label__pox	Polabian
__label__ppl	Pipil
__label__pqm	Malecite-Passamaquoddy
__label__pus	Pushto
__label__rgn	Romagnol
__label__rom	Romany
__label__ron	Romanian
__label__sah	Yakut
__label__san	Sanskrit
__label__sce	Dongxiang
__label__scn	Sicilian
__label__sco	Scots
__label__sdc	Sassarese-Sardinian
__label__sga	Old-Irish-(to-900)
__label__shn	Shan
__label__sia	Akkala-Sami
__label__sid	Sidamo
__label__sin	Sinhala
__label__sjd	Kildin-Sami
__label__skr	Saraiki
__label__slk	Slovak
__label__slr	Salar
__label__slv	Slovenian
__label__sme	Northern-Sami
__label__sms	Skolt-Sami
__label__snd	Sindhi
__label__sqi	Albanian
__label__srd	Sardinian
__label__srn	Sranan-Tongo
__label__srs	Sarsi
__label__stq	Saterfriesisch
__label__swa	Swahili-(macrolanguage)
__label__swe	Swedish
__label__syl	Sylheti
__label__szl	Silesian
__label__tam	Tamil
__label__tel	Telugu
__label__tft	Ternate
__label__tgk	Tajik
__label__tgl	Tagalog
__label__tha	Thai
__label__ton	Tonga-(Tonga-Islands)
__label__tpw	Tupí
__label__tru	Turoyo
__label__tuk	Turkmen
__label__tur	Turkish
__label__twf	Northern-Tiwa
__label__tyv	Tuvinian
__label__tzm	Central-Atlas-Tamazight
__label__uig	Uighur
__label__urd	Urdu
__label__urk	Urak-Lawoi'
__label__vol	Volapük
__label__vot	Votic
__label__wau	Waurá
__label__wbk	Waigali
__label__wiy	Wiyot
__label__wlm	Middle-Welsh
__label__wln	Walloon
__label__xal	Kalmyk
__label__ybi	Yamphu
__label__yid	Yiddish
__label__yor	Yoruba
__label__yue	Yue-Chinese
__label__yue	Yue-Chinese
__label__zha	Zhuang
__label__zho	Chinese
__label__zho	Chinese
__label__zom	Zou
__label__zul	Zulu
